xxxxxxxxxx
x        x
x       xx
x    x   x
x        x
xs  x    x
xx       x
x        x
x    x g x
xxxxxxxxxx